NO ./imgs/no_redbrick.xpm


SO ./imgs/so_redbrick.xpm

WE ./imgs/we_redbrick.xpm
EA ./imgs/ea_redbrick.xpm
F 220           ,          100           ,           0
C 225      ,   30 ,      0

1111111111
1100000001
1000000101
1000W00001
1000000001
1100000011
1000000001
1000000001
1100010011
1111111111
