N ./imgs/no_redbrick.xpm


SO ./imgs/so_redbrick.xpm

WE ./imgs/we_redbrick.xpm
EA ./imgs/ea_redbrick.xpm
C 176,224,230
F 128,128,128
NO ./imgs/no_redbrick.xpm

1111111111
1000000001
1000000101
1000W00101
1000000001
1100000011
1000000001
1000000001
1000010001
1111111111
