NO ./imgs/no_redbrick.xpm
SO ./imgs/so_redbrick.xpm
WE ./imgs/we_redbrick.xpm
EA ./imgs/ea_redbrick.xpm

F 122,122,122
C 255,200,160
                                            11111
                                            10S0111111111
111111111111111111111111111111111111111111111000000000001
100000000000000000000000000000000000000000000000000000001
100000000000000000000000000000000000000000000000000000111
1000000000000000111111111111111111111111111111111111111
10000000000000001
10000000000000001
10000000000000001
10000000000000001
10000000000000001
10000000000000001
10000000000000001
10000000000000001
11111011111111111
    101
11111011111111111
10000000000000001
10000000000000001
10000000000000001
10000000000000001
10000000000000001
10000000000000001
10000000000000001
10000000000000001
10000000000000001
10000000000000001
10000000000000001
11111111111111111
