NO                  ./imgs/no_redbrick.xpm
C                           176                  ,                                 224                        , 230     

SO                   ./imgs/so_redbrick.xpm







EA                     ./imgs/ea_redbrick.xpm



F 128,128,128


WE                    ./imgs/we_redbrick.xpm






                     1111111111111           111111111111111
             11111111110000000000111111111111101111111111111
11111111111111000000000000000000000W111111111111
100000000111000000000000111111111111111111
1001000000000000000000001
1001000000000000000000001
1111111111111111111111111